11111111
1P110111
111E1C11
11111111
11111111
10110111
111E1C11
11111111
11111111
10110111
111E1C11
11111111