1111111111111111
1P011111C011C001
1100000000000101
1000100C01E00011
10C01101110000C1
1111111111111111