1111111111
1101E1C111
10PCC0C0C1
1000110EC1
1111111111